{
    "a": 7,
    "b": 4,
    "v": 20,
    "g": 50,
    "d": 9,
    "e": 24,
    "z": 51,
    "i": 22,
    "j": 17,
    "k": 33,
    "l": 12,
    "m": 21,
    "n": 27,
    "o": 5,
    "p": 3,
    "r": 8,
    "s": 18,
    "t": 44,
    "u": 39,
    "c": 13,
    " ": 0
}